███████████████████████████████████████████████████████████████████████████████████████████████████
s   ███████████                       ██               ███████████████             ████████  ██████
███ ███████████ █████████████ ██████████ ██████ ██████          ██████ ████████ ███████████ ███████
█               █████████████              ████ ███████████████ ██████ ████████             ████ ██
███ █████████████████████████ █████ ███████████ ███████████████        █████████████████████████ ██
███ █████████        ██████ ███████ ██████████████████████████████████████████████████           ██   
███           ██████ ██████ ███████                █████████     █████████████████████ █████████ ██
███ ████████████████ ██████ ███████████████████ ██████████████ ███████████████████████ █████████ ██
███ ████████████████ ██████                     ██████████ ███ ████████████                ████████
███ ████████████████ ██████████████████████████       ████ ███ ████████████ ███████████████████████
███ ████████████████    █████████ █████████████ ██████████ ███ ████████████ ███████████████████████
███ █████████████████████████████ ████████████████████████                  █████████████        ██
███                                    ███████████████████ ████████ █████████             █████████
███ █████████████████████████████ ████████████████████████ ████████ █████████████████████ █████████
███ ██             ██████████████ ████████████████████████ ████████ ████████████████          █████
███ █████ ███████████████████████                          ████████ ████████████████ ██████████████
███ █████ ███████████████████████ █████████████████████████████████ ████████████████ ██████████████
███ ████  █████████████████████████████████████████████████████████ ████████████████ ██████████████
███ ████ ██████████████     ██████          ████████████████                              █████████
███            ████████ ██████████ █████████████████████████ ██████ ███████████████████████████████
██████████████ ████████            █████████████████████████ ██████████████████████████████████████
█████          ████████ ██████████████████                      ███████████████████████████████████
█████ ████████ ████████ ████████████████████████████████████ ██████████████████████████████████████
█████ ████████ ████████ █████████████ ██████████████████████ ██             ███████████████████████
█████ ████████             ██████████ ██████████████████████ ████ █████████ ███████████████████████
█████ ███████████████████████████████ ██████████████████████ ████ █████████ ███████████████████████
█████ ███████████████████████████████      ███               ████ █████████ ███████████████████████
█████ █████████████████ ██████████████████ ███ ██████████████████ █████████               █████   e
█████ █████████████████ ██████████████████     ██████████████████ ███████████████ █████████████ ███
█████ █████████████████ ██████████████████████                         ██████████ ██            ███
█                           ████████████████████████████ ████████████████████████ ██ ██████████████
█████ ██████ █████████████████████████████                      █████████████████ ██ ██████████████
█████ ██████              ██████████████████████████████ ████████████████████████       ███████████
███████████████████████████████████████████████████████████████████████████████████████████████████